15 15
###############
# ##      #   #
# #  # ## # # #
# ## #  # # # #
     #### # # #
######    # # #
#    # # ## # #
#### # #  # # #
#    # #### # #
# ## #      # #
#  # ######## #
## #          #
## ##### ### ##
#      #      #
###### ########
