10 10
##########
# #      #
# # #### #
# # #  # #
# # ## # #
# #    # #
# # ## # #
  #### # #
#      #  
##########