11 12
###########
#   ###   #
# #   ### #
# ####### #
# #     # #
# # # # # #
# # # # # #
# # # # # #
# # # # # #
  # # # # #
#   # #   #
###########
